12 9
RRRRRRRRR
RH RRRRRR
RR RRRRRR
RR  RRRRR
RRR RRRRR
RRR RRRRR
RR  RRRRR
RR RRRRRR
RR RRRRRR
RR RRRRRR
RR RRRRRR
RRZRRRRRR